1111111
1000001
1100111
1P01001
1101111
1E00111
1C00001
1111111