1111111111111111111111111111111111
100000000P000E0C00000C000000000001
1010010100100001010010000000101001
1010010010101010001001000000010101
1111111111111111111111111111111111
1111111111111111111111111111111111